#
# 0 E room0.txt 3
# 1 E room3.txt 0
#
WWWW0WWWWW
W        W
W WWWWWW W
W WF  FW W
W WW  WW W
W  W  W  W
W  WWWW  W
W W    W W
1        W
WWWWWWWWWW
