#
# 0 D room3.txt 2 key1
#
# key1
#
WWWWWWWWWW
Wk       W
WWWWWWW WW
W   T    W
W WWWWWW W
W  T   W W
W      WVW
W   T  WWW
W        0
WWWWWWWWWW
