#
# 0 D room0.txt 1
#
WWWWWWWWWW
W  W     W
W   WWW  W
W     W  W
W   W  W W
W        0
W T W  F W
W      W W
W    h   W
WWWWWWWWWW
